Авантаж – преимущество, выгода.
Адрес-календарь – в царской России: ежегодно издаваемая книга с перечнем должностных лиц всех государственных учреждений.
Адский кaмень  – азотнокислое серебро, применявшееся в медицине как прижигающее, вяжущее средство; ляпис.
Адъютaнт  – офицер, состоявший при военном начальнике для исполнения служебных поручений или ведший делопроизводство в войсковых частях.
Аксельбант  – наплечный отличительный предмет в виде золотого, серебряного или цветного нитяного плетёного шнура с металлическими наконечниками.
Акцизный – в царской России: чиновник, служащий в акцизе – управлении, учреждении по сбору налогов.
Алебарда – старинное оружие в виде насаженного на древко фигурного топорика. оканчивающегося копьём (в России сохранялось у городской стражи до середины XIX века).
Алкать – сильно хотеть, желать чего-либо.
Алтын – старинная русская монета достоинством в три копейки.
Анахорет – человек, живущий одинокой жизнью; удалившийся от мира, отшельник, пустынник.
Анекдот – происшествие, событие необычного характера.
Арапник – длинная охотничья плеть.
Армяк – крестьянский кафтан; верхняя долгополая одежда в виде халата или кафтана из сукна или грубой шерстяной материи.
Артель – объединение лиц той или иной профессии для совместной работы.
Артикул – воинский устав.
Архалук – вид одежды; род короткого кафтана, собранный у талии.
Аршин – старинная русская мера длины, равная 0,711 метра, применявшаяся до введения метрической системы.
Асессор – коллежский асессор – чин VIII класса, равный капитану в армии. 
Аттестат – письменное свидетельство о службе, поведении кого-либо.
Аудитор – военный делопроизводитель; чиновник военного ведомства.
Балаган – временное деревянное здание для театральных и цирковых представлений, получившее распространение на ярмарках и народных гуляниях. 
Балясничать – шутить, балагурить; говорить, рассказывать что-либо забавное и весёлое. 
Барежевый  – сделанный из барежа – шерстяной, шёлковой или хлопчатобумажной ткани редкого плетения.
Барин  – 1. Дворянин, землевладелец, помещик;2. Господин, владелец, хозяин.
Барон  – дворянский титул ниже графского; человек, имеющий титул баронства – низшей степени титулованного дворянства. 
Барышник  – тот, кто занимается перепродажей ради барыша – выгоды, наживы; перекупщик. 
Баталья  – сражение, бой, военные действия. 
Бельведер  – башенка дома, с которой открывается вид на окрестности. 
Билет  – бумажный денежный знак; квитанция, предъявляемая в контору барина для выплаты денег. 
Боа  – женский шарф, повязка из меха или перьев. 
Богадельня  – благотворительное (частное или общественное) учреждение для призрения престарелых или неспособных к труду. 
Богоугодные заведения  – больницы, дома для престарелых, приюты для сирот. 
Боливар  – шляпа с высокими полями. По имени Боливар (Симон Bolivar) – освободитель южно-американских колоний из-под владычества Испании.
Бостон  – род карточной коммерческой игры.
Ботфорты  – сапоги с высоким твёрдым голенищем, с раструбом вверху и подколенной вырезкой. 
Боярин  – крупный землевладелец, занимавший важные административные и военные должности в России до начала XVIII века. Боярыня – жена боярина.
Бранный  – военный. Брань (устар.) – бой, сражение. 
Брегет  – часы со звоном; по имени фабриканта подобных часов, парижского механика Брегета (вернее, Бреге) Абрахама-Луи (1747–1823). 
Бретёр  – любитель драться на дуэли по всякому поводу; задира. 
Бригадир  – военный чин 5-го класса, промежуточный между армейским полковником и генерал-майором. 
Брить лбы  – сдавать крестьян в солдаты, обычно навсегда. 
Бричка  – лёгкая полуоткрытая повозка с откидным кожаным верхом. 
Брыжжи  – оборки на воротничке рубашки и такие же оборки на груди. 
Будочник  – городской сторож, нижний полицейский чин, наблюдавший за порядком в городе и находившийся в будке.
Булава  – длинная палка с шаровидным набалдашником, служившая принадлежностью парадной одежды швейцара у входа в крупные учреждения и частные аристократические дома царской России.
Булат  – 1. Старинная, твёрдая и упругая с узорчатой поверхностью сталь для клинков. 2. Меч, стальной клинок, холодное оружие.
Бурнус  – просторное женское пальто с широкими рукавами.
В случае – в милости у влиятельного лица, под покровительством влиятельных лиц. Ср. у И. А. Крылова – название басни: «Слон в случае». 
Вахмистр  – звание фельдфебеля или старшего унтер-офицера в роте кавалерийского полка.
Венгерка – вид одежды; короткая куртка с нашитыми на груди поперечными шнурами для застёгивания.
Веретено – приспособление для ручного прядения пряжи, одно из древнейших средств производства. Деревянная точёная палочка, оттянутая в острие к верхнему концу и утолщённая к нижней трети.
Верста – старинная русская единица измерения длины, применявшаяся до введения метрической системы и равная 500 саженям или 1,067 км.
Вершок – старинная русская единица измерения длины, равная 4,4 см.; первоначально равнялась длине основной фаланги указательного пальца.
Веси – селения.
Вольная  – вольная запись, документ, по которому крепостной отпускался на свободу.
Всуе – не достигая цели; без необходимости; напрасно.
Газ – лёгкая прозрачная ткань.
Галоп – популярный бальный танец XIX века под музыку размером в две четверти (по счёту раз, два).
Галун – серебряная или мишурная тесьма.
Гарус  – 1. Род грубоватой шерстяной пряжи. 2. Род хлопчатобумажной ткани, на ощупь похожей на шерстяную (гарусную).
Генерал-аншеф  – в царской России: генеральский чин, соответствующий чину полного генерала, стоявшего рангом ниже фельдмаршала.
Генерал-губернатор  – начальник края с высшей военно-административной властью.
Горница  – комната наверху, на верхнем этаже; 2. местн. чистая половина крестьянской избы.
Городовой – в России до 1917 г.: низший чин городской полиции, лицо в этом чине, наблюдавшее за порядком в городе.
Гривенник  – десятикопеечная монета; сумма денег, составляющая десять копеек.
Грош – медная монета в две копейки.
Гумно – огороженный участок земли (или сарай) в крестьянском хозяйстве, предназначенный для хранения, молотьбы и другой обработки зёрен хлеба.
Гусли – старинный щипковый инструмент, напоминавший по форме лиру или лежащую арфу.
Дабы – чтобы; для того, чтобы.
Давеча – недавно. незадолго до разговора.
Дань – подать с населения в Древней Руси, взимавшаяся князем. 
Дворецкий – слуга, заведовавший в доме хозяйством и всей домашней прислугой. 
Девичья – комната для дворовых девушек в помещичьих, барских домах. 
Десница – правая рука. 
Десть – мера счета бумаги, равная 24 листам.
Десятина – мера земли: немного более гектара. 
Десятский – выборный из крестьян или обывателей, исполнявший мелкие полицейские обязанности.
Докука  – надоедливая просьба. 
Дормез  – большая дорожная карета, в которой можно было лежать, вытянувшись во весь рост. 
Драдедам – легкая шерстяная материя для женской праздничной одежды.
Дроги   – 1. Удлиненная повозка без кузова, передняя и задняя части которой соединены продольными брусьями. 
Ермолка   – круглая маленькая шапочка, плотно прилегающая к голове. 
Жалованье  – денежное вознаграждение за службу.
Жандарм – полицейский, состоящий на службе в специальных войсках, предназначенных для политической охраны и сыска. 
Жёлтый билет – паспорт на жёлтом бланке; документ, который давал право легально заниматься проституцией на территории Российской империи. 
Жёлтый дом – в старину название домов для душевнобольных; стены этих домов обычно красили в жёлтый цвет. 
Живот – жизнь. 
Жребий – судьба.
Записной – завзятый, отъявленный, общепринятый.
Запятки – место для слуги, лакея в задней части экипажа. 
Заря – вид травы, которой в народной медицине приписывается целебное действие. 
Застава – в царской России: заграждение на дорогах и въездах в город для опроса, осмотра проезжих, взимания пошлин и т.п. 
Зеленщик – продавец зелени, овощей. 
Зерцало – трехгранная призма с написанными на ее гранях указами Петра I, стоявшая в присутственных местах как символ правосудия.
Зипун – вид одежды; толстый крестьянский кафтан из грубого (домотканого) неокрашенного сукна. 
Идиллия – стихотворение, идеально рисующее сельскую жизнь. 
Извет – донос, сообщение о чем-нибудь властям; наговор, клевета в виде жалобы.
Имение – 1. Земельное владение помещика;2. Имущество, собственность.
Именитый – значительный по своему общественному положению, весьма важный. Иррита́ция – возбуждение, волнение, замешательство (устар. военный термин).
Кабак – ресторан низшего разряда, обычно с гостиницей.
Казакин – род укороченного кафтана, с мелкими сборками у талии сзади и невысоким стоячим воротником; застегивался на крючки.
Камер-лакей – придворная должность: старший лакей при царском дворе.
Камрад – товарищ, приятель (в речи немца; нем. der Kamerad).
Капитан-испавник – в царской России: начальник полиции в уезде, избиравшийся дворянами из своей среды.
Капрал – лицо, имевшее первый после рядового военный чин; унтер-офицер.
Картечь – снаряд, состоявший из чугунных пуль, вложенных в жестянку или мешок, которыми в совокупности стреляли из артиллерийских орудий и мушкетонов. 
Картуз – головной убор с козырьком, неформенная фуражка. 
Кибитка – зимняя крытая повозка на полозьях.
Кивер – высокий военный головной убор из твердой кожи.
Кистень – ручное дорожное старинное оружие, состоящее из металлического шара или гири, прикрепленных ремнем к короткой рукоятке.
Козлы – сиденье для кучера в передке экипажа, повозки; сидеть на ко́злах.
Коллежский регистратор – нижний гражданский чин (равный XIV классу в Табели о рангах) в царской России.
Колодка – деревянный брусок особой формы, надевавшийся на ноги арестантам.
Колодники – арестанты, узники в колодках. 
Котелок – твердая мужская шляпа с круглым выпуклым дном и небольшими полями.
Котильон – танец в быстром темпе, вид кадрили.
Крылатка – верхняя мужская одежда в виде накидки, плаща с пелериной, распространенная в XIX в.-начале XX в.
Куртаг – старинное слово (из франц. cour – двор и немецк. Tag – день) – приемный день при дворе.
Кушак – узкий и длинный пояс из ткани.
Лабазник – торговец, хозяин лабаза ( продуктового склада, лавки).
Ланита – щека.
Лапти – обувь, плетёная из лыка, берёсты или верёвок, которую носили крестьяне.
Ловчий – охотник, который управлял у помещика охотой с собаками.
Лубяной – сделанный из луба (лыковый). Луб – свежий слой древесной коры, отделяемый непосредственно от ствола; лыко.
Лучина – тонкая длинная щепка, использовавшаяся для освещения помещения.
Лыко – внутренняя часть коры молодых лиственных деревьев, а также кусок, полоса такой коры.
Мажордом – в богатом барском доме – управитель дома; дворецкий. Захар, произведенный в мажордомы, с совершенно седыми бакенбардами, накрывает стол. (И.А.Гончаров. Обломов). 
Мазурка  – главный танец на балу, состоящий из многочисленных причудливых фигур и мужского соло.
Манкировать – пренебрегать.
Ментор – воспитатель, наставник (по имени воспитателя Телемака, сына Одиссея, в гомеровской поэме «Одиссея»).
Мусье – (искаж. франц. monsieur) – форма вежливого упоминания или обращения при фамилии или звании; воспитатель, гувернер (обычно о французе).
Нагайка – короткая, толстая плеть из ремней.
Надворный советник – лицо, имеющее гражданский чин седьмого класса по Табели о рангах.
Нанковый – сделанный из нанки – грубой хлопчатобумажной ткани, чаще жёлтого цвета, вышедшей из употребления. 
Наперсники – друзья и доверенные лица, те, кому поверяют сокровенные мысли и тайны.
Нарочный – лицо, посланное с каким-нибудь спешным поручением, гонец.
Натура – природа.
Неавантажный – плохой.
Негоция – торговля, торговая сделка, коммерческое дело.
Недоросль – молодой дворянин, не достигший совершеннолетия и не поступивший на государственную службу. 
Ниже – даже. 
Обиняк – намёк, иносказание. 
Обитель – 1. то же, что монастырь. 2. высок. или шутл. жилище, место проживания. 
Облатка – маленький кружок из клейкого вещества для запечатывания писем, склеивания бумаг.
Облучок – сидение для кучера в повозке.
Облыжно – заведомо ложно.
Оброк – денежный или натуральный сбор, взимавшийся помещиком с крепостного крестьянина.
Однокорытник – одноклассник, однокашник.
Озирать – осматривать, окидывать взором.
Оказия – 1. Редкий. необычный случай;2. Военный конвой, сопровождающий почту и пассажиров на Кавказе.
Око – глаз; очи – глаза.
Оковы – кандалы – железные кольца с цепями, надеваемые на руки и на ноги опасным преступникам.
Околоток – ближайшие окрестности, соседние места.
Околыш – часть головного убора в виде обода, облегающего голову.
Окрест – вокруг; буквально – "местность вокруг креста, окрестность".
Онуча – обмотка для ноги в сапог или лапоть; портянка.
Оный – тот; тот самый.
Опальный – находящийся в опале, впавший в немилость.
Опахало – большой веер.
Опекунский совет – учреждение, ведавшее делами опеки, воспитательными домами, некоторыми кредитными операциями, связанными с залогом имения и т.д.
Опойковый – сделанный из опойка – телячьей кожи.
Опричник – человек, служивший в опричнине – царских войсках, боровшихся с "боярской изменой" во времена Ивана Грозного.
Опричь – за исключением; кроме.
Откуп – в России XIX века – право на взыскание с населения налогов, а также на монопольное ведение торговли или на эксплуатацию предприятия.
Отрок – мальчик-подросток в возрасте между ребёнком и юношей.
Отселе – отсюда.
Оттоле – оттуда.
Палевый – бледно-жёлтого цвета.
Пансион – в царской России: закрытое среднее учебное заведение с проживанием учащихся.
Панталоны – одежда, то же, что и брюки.
Пара чаю – порция чая, подаваемая в двух чайниках – для воды и для заварки.
Партикулярный – частный, неофициальный; штатский.
Пассаж – случай, происшествие.
Паче чаяния – вопреки ожиданию, сверх ожидания.
Пачули – сильно пахнущие духи из эфирного масла, добываемого из листьев и веток тропического ветвистого растения с душистыми листьями.
Перси – грудь.
Пестрядина – грубая ткань из разноцветных ниток, некрашеная, обычно – домотканая.
Повытчик – чиновник в суде; в судах особенно было распространено взяточничество.
Подать – подушный налог, взимавшийся с крестьян.
Поддёвка – русская верхняя распашная длинная (до или ниже колен) одежда с длинными рукавами, отрезная сзади по талии, со сборками на спине, со стоячим или отложным воротником. Носили и мужчины и женщины.
Полицмейстер – начальник полиции города.
Полтина – пятьдесят копеек, монета достоинством в пятьдесят копеек.
Поручик – младший офицерский чин.
Постоялый двор – помещение для ночлега, с двором для лошадей и экипажей проезжих.
Потылица – затылок.
Приказный – мелкий чиновник.
Присяжный пове́ренный – адвокат в царской России.
Притолока – верхний брус в дверях.
Прогоны – плата за проезд на казенных почтовых лошадях.
Пролётка – вариант дрожек для извозчиков; лёгкий открытый четырехколесный двухместный экипаж, преимущественно одноконный.
Рать – войско.
Раут – торжественный званый вечер, прием.
Рачение – старание, усердие.
Ревизская сказка – именной список крепостных крестьян, составлявшийся при переписи (ревизии); производился раз в 7–10 лет.
Редингот – длинный жакет.
Редут – полевое укрепление в виде многоугольника с наружным валом и рвом.
Рек – сказал, произнёс.
Ритор – оратор, который произносит речи пышные, красивые, но пустые, бесполезные.
Роба – одежда, платье.
Рядчик – наниматель рабочих, подрядчик.
Сайдак – зачехлённое оружие, состоящее из лука со стрелами.
Сажень – старорусская единица измерения расстояния. В XVII в. основной мерой была казённая сажень (утверждённая в 1649 году «Соборным уложением»), равная 2,16 м. Около 50 сажен – более 100 метров.
Салоп – верхняя женская одежда в виде накидки с прорезями для рук и небольшими рукавами.
Сатисфакция – удовлетворение за обиду (обычно в форме дуэли, поединка).
Сбитенщик – продавец горячего напитка на меду с пряностями.
Светлица – чистая, светлая комната.
Секундант – свидетель-посредник, сопровождающий каждого из участников дуэли.
Серпянка – редкая льняная ткань.
Сибирка – короткий кафтан с оборками.
Сиделец – лавочник, продавец.
Сикурс – помощь, поддержка в военных действиях.
Смотритель – официальное должностное лицо, которому поручено наблюдение над кем-нибудь или чем-нибудь. Ста́вец – небольшой приделанный к стене шкафчик для посуды.
Староста – в дореволюционной России выборное или назначаемое должностное лицо, выполнявшее административно-полицейские обязанности в сельской общине.
Статский советник – гражданский (статский) чин V класса в российской Табели о рангах до 1917 г.
Стек – короткая тонкая трость с ременной петлёй на конце.
Столоначальник – чиновник; начальник стола (подразделения в министерстве), ведающий каким-нибудь кругом канцелярских дел.
Стремянный – слуга, находящийся во время псовой охоты при господине и наблюдающий за его сворой; конюх-слуга, ухаживающий за лошадью своего господина.
Стряпчий – губернский чиновник, помощник прокурора.
Сюртук – длинный двубортный пиджак.
Тарантас – четырёхколёсная крытая дорожная повозка для длительных поездок. 
Трактир – гостиница с рестораном; ресторан низшего разряда.
Треух – теплая шапка с наушниками.
Тупей – старинная мужская причёска; собранный на затылке пучок волос.
Тягло – подать, бирка, число работающих крестьян, облагавшихся крепостной повинностью.
Уезд  – в дореволюционной России и в СССР до районирования, т. е. до 1929 г. – административно-территориальная единица, составляющая часть губернии.
Улан  – военный из вооружённых пиками частей лёгкой кавалерии.
Учтиво – уважительно, вежливо, любезно.
Фаланстер – очень большое здание типа дворца.
Фармазон – фармазон – искаженное название члена масонской ложи (франк-масон) скоро сделалось ругательством со значением «вольнодумец».
Фиал – стеклянный сосуд с узким горлом.
Форейторский – т. е. принадлежащий форейтору – верховому, который управляет передней парой лошадей, запряженных цугом.
Фунт – русская мера веса, равная 409,5 г.
Холоп – дворовый, крепостной слуга.
Хоромы – в старину на Руси: большой жилой дом богатого владельца, первонач. вообще жилой дом.
Хоры – открытая галерея, балкон в верхней части парадного зала для размещения музыкантов.
Целковый – серебряный рубль, равный трем рублям пятидесяти копейкам ассигнациями.
Целовальник – продавец вина в питейных домах, кабаках.
Цуг – богатый выезд, в котором лошади запряжены гуськом.
Частный пристав – чиновник полиции, заведующий полицией в пределах одного участка (части) города.
Час от часу – с каждым проходящим часом (для обозначения постепенности усиления).
Чело – лоб.
Череда – пора, время.
Чертог – очень большое парадное помещение с пышным убранством.
Шалоновый – из шалона, старинной шерстяной ткани, от названия французского города Шалон.
Швейцарская – помещение для швейцара; швейцар – человек, чьей основной обязанностью является встреча посетителей у входной двери гостиницы, в подъездах учреждений и жилых домов.
Шелепы – плеть, нагайка; также удары, побои, наносимые плетью.
Шинель – верхнее мужское платье с широким, до талии, воротником в виде пелерины, которое носили в XIX веке.
Штабс-капита́н – офицерский чин в пехоте, артиллерии и инженерных войсках, выше поручика, ниже капитана.
Штоф – стеклянный четырехугольный сосуд с коротким горлом; мера, содержащая в себе кружку, или восьмую часть ведра.
Экипаж – повозка для пассажиров.
Эполеты – наплечные знаки различия с шитьем в парадной офицерской форме.
Этажерка – предмет мебели в виде полочек, соединенных стойками и укрепленных друг над другом.
Юдоль – 1. Долина, равнина. 2. Жизненный путь с его заботами, трудностями и печалями. 3. (перен.) Место, где страдают, мучаются, терпят нужду. 4. (перен.) Жребий, удел, участь кого-либо (обычно печальные).
Юнкер – чин (воинское звание) в русской армии до 1918 года, промежуточное по своему правовому статусу между воинскими чинами унтер-офицеров и обер-офицеров; до 60-х годов 19 века: вольноопределяющийся унтер-офицер из дворян.
Юфть – сорт кожи, выделанной на дегте.
Явить – показать, продемонстрировать.
Язык  – народ.
Якобинец  – человек, заподозренный в политическом свободомыслии.
Ямщик  – возница, правящий лошадьми при перевозке на почтовых лошадях пассажиров и грузов.
Ярём – гнёт, иго.
Ярмо – 1. Деревянный хомут для упряжки рабочего рогатого скота. 2. (перен., книжн.) Бремя, тяжесть, иго.
Яство – еда, кушанье. 
Яхонтовый – старинное название рубина, сапфира и некоторых других драгоценных камней.
